#####################################################################
#####..##....#####............##.....................######.........#
###...###.####.####..####..####### ###.#####.####.##########..#######
#..........................#......#.................................#
#######......###....##..#######..#####....#######..#######.##..##..##
#..................#......###.........####..#####.#####............##
#######...#@..####.....#####.....#######.......##.......#######.#####
####......#######..#.######....###.........#######..#.######....#####
###...##......................##...#...##......................######
###.......####..#######..##....###.#.......####..#######..###########
###..#####.....#####......####.....#..#####.....#####################
###.#####.####.##########..#######................................###
#................................###.#####.####.##########..#########
#.........................#......####....#######..#######.##..##..###
###....#######..#######.##..##..#..##...###.##...####..####..########
##.####..#####.#####.................#......#######..#.######....####
##...................#######.########...##......................#####
####......#######..#.######.......###.......####..#######..##########
###...##......................###......................##......######
###.......####..#######..############..#####.....###...........######
#####################################################################