##################################
#................................#
###.#####.####.##########..#######
#.........................#......#
###....#######..#######.##..##..##
##.####..#####.#####............##
###..................#######.#####
####......#######..#.######....###
###...##......................####
###.......####..#######..#########
##################################